html = HTML,html
css = CSS,css,SCSS,scss
javascript = JavaScript,javascript,JS,JSX,js,jsx,EJS,ejs
svelte = svelte
mermaid = Mermaid,mermaid,MERMAID
less = less,Less,LESS
liquid = liquid,LIQUID,Liquid
vue = vue,Vue
turtle = turtle,Turtle,TURTLE
python = python,Python,PYTHON,CYTHON,cython,Cython,py,PY
jupyter notebook = Jupyter Notebook,jupyter notebook
batch = Batchfile,Batchfile,batch
lua = lua,LUA,Lua
bash = bash,BASH,bash,sh
json = JSON,json,jsonl,Json,Jsonl
shell = shell,Shell
zshell = zsh
powershell = powershell,PowerShell
yaml = yaml,YAML,yml,YML
npm = npm,NPM
none = none,None
jinja = jinja,Jinja,jinja2
java = java,Java,jsp
c = c,C
hlsl = hlsl
csharp = csharp,C#,c#
c++ = C++,CPP,cpp,c++
objective-c = objective-c,Objective-C,objc
objective = objective
typescript = typescript,TypeScript,tsx,ts
ini = ini
dockerfile = Dockerfile,dockerfile
ruby = ruby,Ruby
txt = txt,plaintext,text
go = go,Go,GO
pascal = Pascal,pascal
gaml = GAML,gaml
php = php,PHP
markdown = markdown,Markdown
kotlin = kotlin,Kotlin
dart = dart,Dart
solidity = solidity,Solidity
lisp = Emacs Lisp,elisp,lisp,emacs lisp,emacs
rust = rust,Rust,rs
f# = F#,f#
swift = swift,Swift
mdx = mdx,MDX
verilog = verilog,Verilog
clojure = clojure,Clojure
perl = perl,Perl
astro = astro,Astro
game maker language = game maker language,Game Maker Language
zig = zig,Zig
glsl = glsl,GLSL
makefile = makefile,Makefile
make = make
qmake = qmake
cmake = cmake
tex = tex,TeX,latex,bibtex
r = r,R
matlab = matlab,MATLAB
groovy = groovy,Groovy
sql = sql,PLpgSQL,PLSQL,plpgsql,plsql
typeqL = TypeQL,typeql
codeql = codeql,CodeQL,ql,QL
graphql = graphql
nim = Nim,nim
assembly = assembly,Assembly
asl = asl,ASL
apl = apl,APL
nasl = nasl,NASL
api blueprint = api blueprint,API Blueprint
antlr = antlr,ANTLR
arc = arc,Arc
digital command Language = digital command Language,DIGITAL Command Language
haskell = haskell,Haskell
procfile = procfile,Procfile
hcl = hcl,HCL
awk = awk,Awk
shaderlab = shaderLab,ShaderLab,shaderlab
autohotkey = AutoHotkey,autohotkey
coffeescript = CoffeeScript,coffeescript
julia = julia,Julia
apex = Apex,apex
qt script = qt script,Qt Script
asymptote = asymptote,Asymptote
mustache = mustache,Mustache
coq = coq,Coq
nix = nix,Nix
nunjucks = nunjucks,Nunjucks
applescript = applescript,AppleScript
systemverilog = SystemVerilog,SYSTEMVERILOG,systemverilog
vbnet = vbnet,Vbnet
arduino = arduino,Arduino
http = http,HTTP
xml = xml,XML
cmd = cmd,CMD
pseudo = pseudo,PSEUDO
gradle = gradle,Gradle,GRADLE
ocaml = ocaml,OCAML,OCaml
properties = properties,Properties,PROPERTIES
diff = diff,Diff,DIFF
elixir = elixir,ELIXIR
csv = csv,CSV
toml = toml,TOML
prisma = prisma,Prisma
dotenv = dotenv,.env,env,ENV
dot = DOT,dot
razor = razor
vba = vba,VBA
nginx = nginx,Nginx
mathematica = mathematica,Mathematica
vim = vim,Vim,VIM
vimscript = vimscript
svg = svg,SVG
base64 = base64,BASE64
" = "
haxe = haxe
delphi = delphi
proto = proto
sudolang = SudoLang,sudolang
regex = regex
tf = tf
url = url
xef = xef
excel = excel
dslx = dslx
plantuml = plantuml
janet = janet